=================
= X     $       =
= X     $       =
= X     $$$$$$  =
= X     $       =
=================
= %             =
=================
